0 0 0 inicio 0 0 0 0 0 0 0 0 0
X X X 0 X X X X X X X X X
X 1 X 2 0 3 0 4 X 5 0 6 X
X 0 X 0 0 0 X 0 X 0 X X X
X 7 X 8 0 9 X 10 X 11 X 12 X
X 0 X X X X X 0 X 0 X 0 X
X 13 0 14 0 15 X 16 X 17 X 18 X
X X X 0 X 0 X 0 X 0 X 0 X 
X 19 X 20 X 21 0 22 X 23 X 24 X
X 0 X 0 X X X X X 0 X 0 X
X 25 X 26 0 27 0 28 0 29 X 30 X
X 0 X X X X X 0 X X X 0 X
X 31 0 32 0 33 0 34 0 35 0 36 X
X X X 0 X X X X X X X X X
0 0 0 fin 0 0 0 0 0 0 0 0 0
